3,0,0,1,1,0,1,1,0,1,1,0,0,3X
3,2,2,2,2,2,2,2,2,2,2,2,2,3X
3,0,0,1,0,0,0,0,0,0,1,0,0,3X
3,2,2,2,2,2,2,2,2,2,2,2,2,3X
3,0,0,0,1,0,1,1,0,1,0,0,0,3X
2,2,2,2,2,2,2,2,2,2,2,2,2,2X
0,0,0,0,1,1,1,1,1,1,0,0,0,0X
2,2,2,2,1,2,1,1,2,1,2,2,2,2X
0,0,0,0,1,0,1,1,0,1,0,0,0,0X
1,1,1,0,1,0,1,1,0,1,0,1,1,1X
1,2,1,2,2,2,2,2,2,2,2,1,0,1X
1,0,1,0,0,0,0,0,0,0,0,1,0,1X
