3,3,3,3,3,3,3,3,3,3,3,3,3,3X
3,1,1,1,2,1,1,1,1,2,1,1,1,3X
3,1,3,1,2,1,3,3,1,2,1,3,1,3X
3,1,1,1,0,1,1,1,1,0,1,1,1,3X
3,2,2,0,2,0,2,2,0,2,0,2,2,3X
3,1,1,1,1,1,1,1,1,1,1,1,1,3X
3,1,2,2,2,2,2,2,2,2,2,2,1,3X
3,1,2,0,1,0,1,1,0,1,0,2,1,3X
3,1,2,0,1,0,2,2,0,1,0,2,1,3X
3,1,2,2,2,2,3,3,2,2,2,2,1,3X
3,1,1,1,1,1,1,1,1,1,1,1,1,3X
2,2,2,2,2,2,2,2,2,2,2,2,2,2X
