1,1,1,1,1,1,1,1,1,1,1,1,1,1X
2,2,2,2,2,2,2,2,2,2,2,2,2,1X
0,0,0,0,0,0,0,0,0,0,0,0,0,0X
1,2,2,2,2,2,2,2,2,2,2,2,2,2X
0,0,0,0,0,0,0,0,0,0,0,0,0,0X
2,2,2,2,2,2,2,2,2,2,2,2,2,1X
0,0,0,0,0,0,0,0,0,0,0,0,0,0X
1,2,2,2,2,2,2,2,2,2,2,2,2,2X
0,0,0,0,0,0,0,0,0,0,0,0,0,0X
2,2,2,2,2,2,2,2,2,2,2,2,2,1X
0,0,0,0,0,0,0,0,0,0,0,0,0,0X
1,2,2,2,2,2,2,2,2,2,2,2,2,2X
