3,0,0,0,0,0,1,1,0,0,0,0,0,3X
3,0,0,0,0,0,1,1,0,0,0,0,0,3X
3,2,2,2,2,2,1,1,2,2,2,2,2,3X
3,0,2,0,0,1,3,3,1,0,0,2,0,3X
3,0,2,0,1,1,1,1,1,1,0,2,0,3X
2,2,2,0,1,3,2,2,3,1,0,2,2,2X
0,0,2,0,1,1,1,1,1,1,0,2,0,0X
0,0,2,0,0,0,0,0,0,0,0,2,0,0X
2,2,2,2,2,2,2,2,2,2,2,2,2,2X
1,3,3,3,1,0,1,1,0,1,3,3,3,1X
1,1,1,1,1,1,1,1,1,1,1,1,1,1X
2,1,2,1,2,1,2,1,2,1,2,1,2,1X
