0,0,0,0,0,0,2,2,0,0,0,0,0,0X
0,0,0,1,1,1,2,2,1,1,1,0,0,0X
1,1,1,1,1,1,2,2,1,1,1,1,1,1X
0,3,2,0,0,1,3,3,1,0,0,2,3,2X
1,1,1,2,2,2,2,2,2,2,2,1,1,1X
0,1,0,1,0,1,1,1,1,0,1,0,1,0X
1,0,1,0,1,1,3,3,1,1,0,1,0,1X
0,1,0,1,0,1,1,1,1,0,1,0,1,0X
1,0,1,0,1,1,3,3,1,1,0,1,0,1X
0,1,0,1,0,1,1,1,1,0,1,0,1,0X
1,3,3,3,1,1,1,1,1,1,3,3,3,1X
2,2,2,2,2,2,2,2,2,2,2,2,2,2X
