1,1,1,1,0,1,1,1,1,0,1,1,1,1X
1,2,1,0,1,0,0,0,0,1,0,1,2,1X
1,2,1,2,2,2,2,2,2,2,2,1,2,1X
1,1,1,0,1,0,1,1,0,1,0,1,1,1X
1,0,0,0,1,0,3,3,0,1,0,0,0,1X
1,1,1,1,1,0,1,1,0,1,1,1,1,1X
1,2,2,2,2,2,2,2,2,2,2,2,2,1X
1,0,0,3,0,0,0,0,0,0,3,0,0,1X
0,1,0,1,0,1,1,1,1,0,1,0,1,0X
1,0,1,0,1,2,2,2,2,1,0,1,0,1X
2,2,2,2,2,2,2,2,2,2,2,2,2,2X
0,1,1,1,0,0,1,1,0,0,1,1,1,0X
