1,1,1,1,1,1,1,1,1,1,1,1,1,1X
1,0,1,0,2,0,1,1,0,2,0,1,0,1X
2,2,2,2,2,2,2,2,2,2,2,2,2,2X
1,0,1,0,0,0,3,3,0,0,0,1,0,1X
2,2,2,2,2,2,2,2,2,2,2,2,2,2X
1,0,1,0,2,0,1,1,0,2,0,1,0,1X
1,1,1,1,1,1,1,1,1,1,1,1,1,1X
2,0,1,0,0,0,1,1,0,0,0,1,0,2X
2,2,2,2,2,2,2,2,2,2,2,2,2,2X
1,1,1,1,1,1,1,1,1,1,1,1,1,1X
1,3,3,3,1,0,1,1,0,1,3,3,3,1X
1,1,1,1,1,2,2,2,2,1,1,1,1,1X
