1,1,1,0,1,0,1,1,0,1,0,1,1,1X
1,2,1,0,0,1,0,0,1,0,0,1,2,1X
1,3,1,2,2,2,2,2,2,2,2,1,3,1X
1,1,1,0,1,1,1,1,1,1,0,1,1,1X
0,0,0,0,1,2,0,0,2,1,0,0,0,0X
2,2,2,2,1,0,3,3,0,1,2,2,2,2X
2,0,0,0,1,0,3,3,0,1,0,0,0,2X
2,2,2,2,1,2,0,0,2,1,0,0,2,2X
1,1,1,2,1,1,1,1,1,1,2,2,1,1X
1,3,1,2,0,0,0,0,0,0,2,1,3,1X
1,2,1,2,2,2,2,2,2,2,2,1,2,1X
1,2,1,0,0,0,1,1,0,0,0,1,2,1X
